##############W####
############## ####
##BPIC...##......##
##.....######....##
##.....######....##
##.......F....S..##
##.........##....##
############## ####
##############W####
