#################
#.......#.......#
#..S..######....#
#...........P...#
#..........#....#
#################
